116
0 5 5 0 M 71
0 0 5 5 F 12
0 4 0 0 M 51
0 0 0 4 M 44
4 4 1 1 M 91
3 0 0 0 M 87
3 3 0 0 M 78
0 0 3 0 M 105
0 3 1 0 F 26
0 3 3 0 M 93
2 3 1 0 F 13
0 0 1 3 M 95
0 0 3 3 M 72
0 0 3 3 M 111
0 3 3 3 F 7
2 3 3 3 F 35
2 0 0 0 F 25
2 0 0 0 X 2
2 0 0 0 X 3
0 2 0 0 F 28
0 2 0 0 M 53
2 2 0 0 F 16
2 2 0 0 F 19
2 2 0 0 F 27
0 2 2 0 F 40
0 0 0 2 M 89
0 0 2 2 F 8
0 0 2 2 F 20
0 0 2 2 F 39
0 0 2 2 M 83
0 2 2 1 M 61
2 2 1 1 F 24
2 2 2 2 F 31
1 2 2 2 M 65
2 2 2 2 M 84
2 2 2 2 X 1
2 2 2 2 X 4
1 0 0 0 F 33
1 0 0 0 F 38
1 0 0 0 M 54
1 0 0 0 M 92
1 0 0 0 M 96
1 0 0 0 M 101
1 0 0 0 M 114
1 0 0 0 M 116
0 1 0 0 M 49
0 1 0 0 M 68
0 1 0 0 M 100
1 1 0 0 F 9
1 1 0 0 F 15
1 1 0 0 F 23
1 1 0 0 F 29
1 1 0 0 F 30
1 1 0 0 F 34
1 1 0 0 M 47
1 1 0 0 M 50
1 1 0 0 M 60
1 1 0 0 M 63
1 1 0 0 M 66
1 1 0 0 M 76
1 1 0 0 M 80
1 1 0 0 M 81
1 1 0 0 M 85
1 1 0 0 M 94
1 1 0 0 M 104
1 1 0 0 M 115
0 0 1 0 F 42
0 0 1 0 M 46
0 0 1 0 M 79
0 1 1 0 F 17
0 1 1 0 M 56
0 1 1 0 M 67
0 1 1 0 M 109
0 1 1 0 M 110
0 1 1 0 M 113
1 1 1 0 M 59
0 0 0 1 F 11
0 0 0 1 M 75
1 1 0 1 M 98
0 0 1 1 F 10
0 0 1 1 F 18
0 0 1 1 F 21
0 0 1 1 F 22
0 0 1 1 M 6
0 0 1 1 M 43
0 0 1 1 M 55
0 0 1 1 M 57
0 0 1 1 M 64
0 0 1 1 M 73
0 0 1 1 M 74
0 0 1 1 M 90
0 0 1 1 M 97
0 0 1 1 M 99
0 0 1 1 M 103
0 0 1 1 M 107
0 0 1 1 M 108
0 0 1 1 M 112
0 1 1 1 M 45
0 1 1 1 M 58
0 1 1 1 M 77
0 1 1 1 M 86
0 1 1 1 M 88
1 1 1 1 F 5
1 1 1 1 F 14
1 1 1 1 F 32
1 1 1 1 F 36
1 1 1 1 F 37
1 1 1 1 F 41
1 1 1 1 M 48
1 1 1 1 M 52
1 1 1 1 M 62
1 1 1 1 M 69
1 1 1 1 M 70
1 1 1 1 M 82
1 1 1 1 M 102
1 1 1 1 M 106
51
1 13
1 10
4 4
4 4
4 3
4 3
4 3
4 3
4 2
4 2
4 2
4 2
4 2
4 2
4 2
3 2
3 2
3 2
3 2
3 2
3 2
3 2
3 2
3 2
3 2
3 2
3 2
5 1
5 1
5 1
5 1
5 1
5 1
5 1
5 1
5 1
3 2
5 1
2 1
2 1
2 1
2 1
2 1
2 1
2 1
2 1
2 1
2 1
2 1
2 1
2 1